region,orden_reg,distrito,com_nom,cod_servel,cod_casen,padron,vot_boric,vot_kast,vot_nulo,vot_blanco,vot_validos,vot_tot,participacion,per_pob2020
DE VALPARAISO,6,DISTRITO 7,ALGARROBO,2564,5602,14805,4580,5096,61,23,9676,9760,0.6592367443431273,0.09647623669295971
METROPOLITANA DE SANTIAGO,7,DISTRITO 14,ALHUE,2801,13502,6118,1952,1092,9,9,3044,3062,0.5004903563255966,0.07195675933170456
DEL BIOBIO,11,DISTRITO 21,ALTO BIOBIO,2674,8314,5583,1283,1069,48,20,2352,2420,0.43345871395307184,0.2892709776332985
DE ATACAMA,4,DISTRITO 4,ALTO DEL CARMEN,2523,3302,5148,1236,701,23,5,1937,1965,0.3817016317016317,0.1277138289175974
DE TARAPACA,2,DISTRITO 2,ALTO HOSPICIO,2502,1107,60343,11971,11897,279,64,23868,24211,0.4012230084682565,0.1609218325218222
DE LOS LAGOS,14,DISTRITO 26,ANCUD,2717,10202,38912,10412,8225,118,48,18637,18803,0.48321854440789475,0.1206033473866003
DE COQUIMBO,5,DISTRITO 5,ANDACOLLO,2528,4103,11278,4274,1480,61,18,5754,5833,0.5172016314949459,0.1116838823475293
DE LA ARAUCANIA,12,DISTRITO 22,ANGOL,2696,9201,46976,7931,16634,181,62,24565,24808,0.528099455040872,0.1486996364033379
DE MAGALLANES Y DE LA ANTARTICA CHILENA,16,DISTRITO 28,ANTARTICA,2752,NA,233,7,26,0,0,33,33,0.14163090128755365,NA
DE ANTOFAGASTA,3,DISTRITO 3,ANTOFAGASTA,2508,2101,289086,80734,52976,1392,388,133710,135490,0.4686840594148454,0.08254209896171957
DEL BIOBIO,11,DISTRITO 21,ANTUCO,2662,8302,4687,982,1188,28,7,2170,2205,0.47045018135267763,0.1472194208619249
DEL BIOBIO,11,DISTRITO 21,ARAUCO,2655,8202,31244,7429,9296,171,51,16725,16947,0.5424081423633338,0.1304801189375123
DE ARICA Y PARINACOTA,1,DISTRITO 1,ARICA,2822,15101,180736,43248,41586,804,247,84834,85885,0.4751958657932011,0.117570668124598
DE AYSEN DEL GENERAL CARLOS IBAÑEZ DEL CAMPO,15,DISTRITO 27,AYSEN,2739,11201,22646,6354,3924,69,38,10278,10385,0.45857988165680474,0.0692517002603307
METROPOLITANA DE SANTIAGO,7,DISTRITO 14,BUIN,2797,13402,78010,26268,20391,358,105,46659,47122,0.6040507627227278,0.08511276986700748
DE ÑUBLE,10,DISTRITO 19,BULNES,2827,16102,20644,4313,6184,69,27,10497,10593,0.5131273009106763,0.1536730703616999
DE VALPARAISO,6,DISTRITO 6,CABILDO,2554,5402,18033,6590,3071,71,24,9661,9756,0.5410081517218432,0.08537028594120621
DE MAGALLANES Y DE LA ANTARTICA CHILENA,16,DISTRITO 28,CABO DE HORNOS(EX-NAVARINO),2751,NA,1862,272,495,1,0,767,768,0.41245972073039744,NA
DEL BIOBIO,11,DISTRITO 21,CABRERO,2663,8303,25305,4768,7829,102,38,12597,12737,0.5033392610156096,0.1335311736505896
DE ANTOFAGASTA,3,DISTRITO 3,CALAMA,2512,2201,131956,30837,25654,873,177,56491,57541,0.43606202067355787,0.1060436125095491
DE LOS LAGOS,14,DISTRITO 26,CALBUCO,2708,10102,32505,6523,7418,107,56,13941,14104,0.4339024765420704,0.1127535198795554
DE ATACAMA,4,DISTRITO 4,CALDERA,2518,3102,15266,5485,2494,67,20,7979,8066,0.5283636840036683,0.1031179389915699
DE VALPARAISO,6,DISTRITO 6,CALERA,2559,5502,44870,16264,8347,194,56,24611,24861,0.5540673055493648,0.1335478310051026
METROPOLITANA DE SANTIAGO,7,DISTRITO 14,CALERA DE TANGO,2798,13403,22524,7141,7135,107,45,14276,14428,0.6405611791866453,0.09244509091962214
DE VALPARAISO,6,DISTRITO 6,CALLE LARGA,2550,5302,11602,4309,2525,62,18,6834,6914,0.5959317359076022,0.1143297481626175
DE ARICA Y PARINACOTA,1,DISTRITO 1,CAMARONES,2823,15102,3196,430,444,7,4,874,885,0.27690863579474345,0.2279384022500303
DE TARAPACA,2,DISTRITO 2,CAMINA,2504,1402,2639,151,706,9,0,857,866,0.32815460401667296,0.2278801485465134
DE COQUIMBO,5,DISTRITO 5,CANELA,2533,4202,9203,3325,1497,20,21,4822,4863,0.5284146473975877,0.1457791946588981
DEL BIOBIO,11,DISTRITO 21,CANETE,2656,8203,29725,5419,10054,125,41,15473,15639,0.5261227922624054,0.1866344861136739
DE LA ARAUCANIA,12,DISTRITO 23,CARAHUE,2676,9102,24663,4430,7167,82,39,11597,11718,0.4751246806957791,0.2286996441708587
DE VALPARAISO,6,DISTRITO 7,CARTAGENA,2565,5603,18730,6229,4395,75,23,10624,10722,0.5724506139882541,0.1841740970863391
DE VALPARAISO,6,DISTRITO 7,CASABLANCA,2542,5102,22793,7086,6019,102,31,13105,13238,0.5807923485280568,0.09597197597836443
DE LOS LAGOS,14,DISTRITO 26,CASTRO,2716,10201,41866,12308,8276,167,68,20584,20819,0.4972770267042469,0.09029189316820299
DE VALPARAISO,6,DISTRITO 6,CATEMU,2570,5702,12173,4026,2265,49,12,6291,6352,0.5218105643637558,0.1101907033187955
DEL MAULE,9,DISTRITO 18,CAUQUENES,2622,7201,37684,6219,13299,123,40,19518,19681,0.5222640908608428,0.131231803871192
METROPOLITANA DE SANTIAGO,7,DISTRITO 8,CERRILLOS,2759,13102,66557,24001,13818,257,70,37819,38146,0.5731328034616945,0.08993810122669317
METROPOLITANA DE SANTIAGO,7,DISTRITO 9,CERRO NAVIA,2760,13103,113693,42576,18051,358,128,60627,61113,0.5375264967939979,0.128717316014407
DE LOS LAGOS,14,DISTRITO 26,CHAITEN,2733,10401,5094,883,1087,15,10,1970,1995,0.3916372202591284,0.1026064871447397
DEL MAULE,9,DISTRITO 18,CHANCO,2623,7202,9369,1584,3515,44,15,5099,5158,0.5505390116341125,0.1571955347035693
DE ATACAMA,4,DISTRITO 4,CHANARAL,2520,3201,11980,4004,1446,38,15,5450,5503,0.4593489148580968,0.1015910567360753
DEL LIBERTADOR GENERAL BERNARDO O'HIGGINS,8,DISTRITO 16,CHEPICA,2603,6302,13827,3374,3520,42,13,6894,6949,0.5025674405149345,0.1395769719414517
DEL BIOBIO,11,DISTRITO 20,CHIGUAYANTE,2644,8103,68015,23040,17892,381,111,40932,41424,0.6090421230610895,0.1087466112681254
DE AYSEN DEL GENERAL CARLOS IBAÑEZ DEL CAMPO,15,DISTRITO 27,CHILE CHICO,2745,11401,6423,1421,838,31,7,2259,2297,0.3576210493538845,0.06331774887604207
DE ÑUBLE,10,DISTRITO 19,CHILLAN,2826,16101,153992,40277,45331,684,192,85608,86484,0.56161359031638,0.1373264021864332
DE ÑUBLE,10,DISTRITO 19,CHILLAN VIEJO,2828,16103,22712,6085,7189,96,25,13274,13395,0.5897763296935541,0.1458816552876249
DEL LIBERTADOR GENERAL BERNARDO O'HIGGINS,8,DISTRITO 16,CHIMBARONGO,2604,6303,30692,8654,7024,86,43,15678,15807,0.5150202007037664,0.1067880399219578
DE LA ARAUCANIA,12,DISTRITO 23,CHOLCHOL,2695,9121,11149,2690,3332,73,18,6022,6113,0.5483002959906718,0.2331448161588211
DE LOS LAGOS,14,DISTRITO 26,CHONCHI,2718,10203,13357,3964,2386,46,26,6350,6422,0.48079658605974396,0.1329975382874391
DE AYSEN DEL GENERAL CARLOS IBAÑEZ DEL CAMPO,15,DISTRITO 27,CISNES,2740,11202,4642,1183,1245,9,7,2428,2444,0.5264971994829815,0.08285568258702605
DE ÑUBLE,10,DISTRITO 19,COBQUECURA,2836,16202,5904,1483,1956,25,12,3439,3476,0.5887533875338753,0.1917782951128403
DE LOS LAGOS,14,DISTRITO 26,COCHAMO,2709,10103,4636,690,1225,18,16,1915,1949,0.42040552200172565,0.170784334066917
DE AYSEN DEL GENERAL CARLOS IBAÑEZ DEL CAMPO,15,DISTRITO 27,COCHRANE,2742,11301,3384,843,791,15,10,1634,1659,0.49024822695035464,0.09859076695901245
DEL LIBERTADOR GENERAL BERNARDO O'HIGGINS,8,DISTRITO 15,CODEGUA,2580,6102,11661,3986,2447,49,13,6433,6495,0.556984821198868,0.1307581823847938
DE ÑUBLE,10,DISTRITO 19,COELEMU,2837,16203,15372,3733,5184,57,14,8917,8988,0.5846994535519126,0.125737476517724
DE ÑUBLE,10,DISTRITO 19,COIHUECO,2843,16302,22439,3446,8655,71,31,12101,12203,0.5438299389455858,0.1665296630224565
DEL LIBERTADOR GENERAL BERNARDO O'HIGGINS,8,DISTRITO 15,COINCO,2581,6103,7305,2153,1932,25,10,4085,4120,0.5639972621492129,0.1324412717881086
DEL MAULE,9,DISTRITO 18,COLBUN,2635,7402,18716,4973,4196,52,35,9169,9256,0.4945501175464843,0.1480801137891988
DE TARAPACA,2,DISTRITO 2,COLCHANE,2505,1403,3217,52,928,3,1,980,984,0.3058750388560771,0.2108700694260946
METROPOLITANA DE SANTIAGO,7,DISTRITO 8,COLINA,2793,13301,94052,22453,32653,509,198,55106,55813,0.5934270403606515,0.08575312542923863
DE LA ARAUCANIA,12,DISTRITO 22,COLLIPULLI,2697,9202,22172,3571,7623,78,39,11194,11311,0.5101479343315893,0.1963139091909959
DEL LIBERTADOR GENERAL BERNARDO O'HIGGINS,8,DISTRITO 15,COLTAUCO,2582,6104,16381,4844,3829,60,23,8673,8756,0.5345217019717966,0.1112126825239512
DE COQUIMBO,5,DISTRITO 5,COMBARBALA,2537,4302,12522,3876,1898,40,14,5774,5828,0.46542085928765375,0.1338800041074522
DEL BIOBIO,11,DISTRITO 20,CONCEPCION,2642,8101,200269,60654,55618,1051,336,116272,117659,0.5875048060358817,0.1093322942628359
METROPOLITANA DE SANTIAGO,7,DISTRITO 9,CONCHALI,2761,13104,116290,43294,21464,445,144,64758,65347,0.5619313784504256,0.1244445433199645
DE VALPARAISO,6,DISTRITO 7,CONCON,2543,5103,40829,12555,15012,304,131,27567,28002,0.6858360479071248,0.08184432292608097
DEL MAULE,9,DISTRITO 17,CONSTITUCION,2613,7102,40149,10774,10056,214,65,20830,21109,0.5257665197140651,0.1120622810606706
DEL BIOBIO,11,DISTRITO 21,CONTULMO,2657,8204,6114,1059,2390,20,7,3449,3476,0.5685312397775597,0.1682856500565809
DE ATACAMA,4,DISTRITO 4,COPIAPO,2517,3101,124441,38215,23707,521,153,61922,62596,0.5030174942342154,0.08633782300382041
DE COQUIMBO,5,DISTRITO 5,COQUIMBO,2527,4102,171212,53671,31884,769,255,85555,86579,0.5056830128729295,0.107583661103928
DEL BIOBIO,11,DISTRITO 20,CORONEL,2643,8102,90394,26674,22136,469,111,48810,49390,0.5463858220678364,0.1381523617193343
DE LOS RIOS,13,DISTRITO 24,CORRAL,2811,14102,5546,1844,1000,13,6,2844,2863,0.5162279120086549,0.1542855394677075
DE AYSEN DEL GENERAL CARLOS IBAÑEZ DEL CAMPO,15,DISTRITO 27,COYHAIQUE,2737,11101,54221,14430,11650,199,82,26080,26361,0.48617694251304844,0.05849552755128693
DE LA ARAUCANIA,12,DISTRITO 23,CUNCO,2677,9103,20105,3407,5833,65,13,9240,9318,0.4634667993036558,0.2074481008814761
DE LA ARAUCANIA,12,DISTRITO 22,CURACAUTIN,2698,9203,21097,2725,6306,53,25,9031,9109,0.43176754988860977,0.2011994188839145
METROPOLITANA DE SANTIAGO,7,DISTRITO 14,CURACAVI,2802,13503,27147,9652,6865,129,43,16517,16689,0.6147640623273289,0.09549868358817849
DE LOS LAGOS,14,DISTRITO 26,CURACO DE VELEZ,2719,10204,3770,1041,762,20,9,1803,1832,0.48594164456233424,0.1462712326671376
DEL BIOBIO,11,DISTRITO 21,CURANILAHUE,2658,8205,30382,7474,7493,128,54,14967,15149,0.4986176025278125,0.1368396232140789
DE LA ARAUCANIA,12,DISTRITO 23,CURARREHUE,2678,9104,8521,1474,2411,28,9,3885,3922,0.4602746156554395,0.2476218022398686
DEL MAULE,9,DISTRITO 17,CUREPTO,2614,7103,10330,2834,2433,42,19,5267,5328,0.5157792836398838,0.1275885562997483
DEL MAULE,9,DISTRITO 17,CURICO,2625,7301,118541,36040,32035,548,180,68075,68803,0.5804152149889068,0.1010600991607528
DE LOS LAGOS,14,DISTRITO 26,DALCAHUE,2720,10205,12772,3024,2616,46,24,5640,5710,0.4470717193861572,0.1179428822520927
DE ATACAMA,4,DISTRITO 4,DIEGO DE ALMAGRO,2521,3202,13101,3932,1281,59,14,5213,5286,0.40348065033203573,0.08317232466203732
DEL LIBERTADOR GENERAL BERNARDO O'HIGGINS,8,DISTRITO 15,DONIHUE,2583,6105,18597,6427,4136,78,26,10563,10667,0.5735871377103834,0.09168316070134791
METROPOLITANA DE SANTIAGO,7,DISTRITO 13,EL BOSQUE,2762,13105,135969,49629,25753,501,135,75382,76018,0.5590833204627526,0.125609144671792
DE ÑUBLE,10,DISTRITO 19,EL CARMEN,2829,16104,12469,2008,4738,30,19,6746,6795,0.5449514796695806,0.1708490651218286
METROPOLITANA DE SANTIAGO,7,DISTRITO 14,EL MONTE,2806,13602,28129,10139,6232,145,47,16371,16563,0.5888229229620676,0.1173566559698672
DE VALPARAISO,6,DISTRITO 7,EL QUISCO,2566,5604,14675,5413,3972,68,13,9385,9466,0.6450425894378194,0.1189421000759363
DE VALPARAISO,6,DISTRITO 7,EL TABO,2567,5605,12832,5030,3287,60,15,8317,8392,0.6539900249376559,0.1511497511780771
DEL MAULE,9,DISTRITO 17,EMPEDRADO,2615,7104,4523,644,1797,31,8,2441,2480,0.548308644704842,0.1641904952039295
DE LA ARAUCANIA,12,DISTRITO 22,ERCILLA,2699,9204,8036,1632,2232,34,10,3864,3908,0.48631159780985567,0.2367310403610821
METROPOLITANA DE SANTIAGO,7,DISTRITO 8,ESTACION CENTRAL,2763,13106,125639,41330,22393,471,155,63723,64349,0.51217376769952,0.1167853268222691
DEL BIOBIO,11,DISTRITO 20,FLORIDA,2645,8104,10550,2181,3442,55,16,5623,5694,0.5397156398104266,0.1592122725799187
DE LA ARAUCANIA,12,DISTRITO 23,FREIRE,2679,9105,22892,4428,6578,86,36,11006,11128,0.4861086842565088,0.1879164502537262
DE ATACAMA,4,DISTRITO 4,FREIRINA,2524,3303,6051,2132,746,23,7,2878,2908,0.4805817220294166,0.1282592080571183
DE LOS LAGOS,14,DISTRITO 25,FRESIA,2710,10104,12172,2912,3501,51,20,6413,6484,0.532697995399277,0.1909900851785052
DE LOS LAGOS,14,DISTRITO 25,FRUTILLAR,2711,10105,17227,4276,5333,75,20,9609,9704,0.5633017936959425,0.1207915368663827
DE LOS LAGOS,14,DISTRITO 26,FUTALEUFU,2734,10402,3885,558,855,14,5,1413,1432,0.3685971685971686,0.1348302391269383
DE LOS RIOS,13,DISTRITO 24,FUTRONO,2819,14202,14801,2786,4902,60,28,7688,7776,0.5253699074386866,0.1586757242714591
DE LA ARAUCANIA,12,DISTRITO 22,GALVARINO,2680,9106,12092,2734,3326,41,26,6060,6127,0.5066986437313926,0.2378400924547613
DE ARICA Y PARINACOTA,1,DISTRITO 1,GENERAL LAGOS,2825,15202,1948,65,251,9,1,316,326,0.1673511293634497,0.2579186310977353
DE LA ARAUCANIA,12,DISTRITO 23,GORBEA,2681,9107,15651,2549,5486,57,17,8035,8109,0.5181138585393904,0.1908214915695148
DEL LIBERTADOR GENERAL BERNARDO O'HIGGINS,8,DISTRITO 15,GRANEROS,2584,6106,27062,10092,5673,120,48,15765,15933,0.5887591456655088,0.1027154234743405
DE AYSEN DEL GENERAL CARLOS IBAÑEZ DEL CAMPO,15,DISTRITO 27,GUAITECAS,2741,11203,1696,365,259,6,0,624,630,0.3714622641509434,0.07369173261708538
DE VALPARAISO,6,DISTRITO 6,HIJUELAS,2560,5503,15727,4721,3693,76,28,8414,8518,0.5416163286068545,0.1322847507635165
DE LOS LAGOS,14,DISTRITO 26,HUALAIHUE,2735,10403,8774,2046,2181,33,21,4227,4281,0.4879188511511283,0.1285428174993678
DEL MAULE,9,DISTRITO 17,HUALANE,2626,7302,9788,3167,2442,35,27,5609,5671,0.5793829178586024,0.1278457125026535
DEL BIOBIO,11,DISTRITO 20,HUALPEN,2653,8112,77313,26020,20086,406,96,46106,46608,0.602848162663459,0.1037599426965436
DEL BIOBIO,11,DISTRITO 20,HUALQUI,2646,8105,20705,5354,5317,100,35,10671,10806,0.521902921999517,0.1724081217988391
DE TARAPACA,2,DISTRITO 2,HUARA,2506,1404,9045,545,990,18,5,1535,1558,0.1722498618021006,0.2029571912725485
DE ATACAMA,4,DISTRITO 4,HUASCO,2525,3304,8454,3131,1212,36,9,4343,4388,0.5190442394132955,0.09818844994379101
METROPOLITANA DE SANTIAGO,7,DISTRITO 9,HUECHURABA,2764,13107,74581,28683,18931,493,161,47614,48268,0.6471889623362519,0.08249161467636315
DE COQUIMBO,5,DISTRITO 5,ILLAPEL,2532,4201,27992,9971,4239,95,40,14210,14345,0.512467847956559,0.1195009177724981
METROPOLITANA DE SANTIAGO,7,DISTRITO 9,INDEPENDENCIA,2765,13108,82526,24430,15505,291,119,39935,40345,0.4888762329447689,0.1393396243004002
DE TARAPACA,2,DISTRITO 2,IQUIQUE,2501,1101,167349,39346,40072,733,238,79418,80389,0.48036737596280826,0.1235476733178545
METROPOLITANA DE SANTIAGO,7,DISTRITO 14,ISLA DE MAIPO,2807,13603,28606,10118,7141,97,34,17259,17390,0.6079144235475075,0.1146184649258176
DE VALPARAISO,6,DISTRITO 7,ISLA DE PASCUA,2548,5201,6493,2016,853,39,15,2869,2923,0.45017711381487757,0.1175426398105298
DE VALPARAISO,6,DISTRITO 7,JUAN FERNANDEZ,2544,5104,930,282,118,0,1,400,401,0.4311827956989247,0.122933148907687
METROPOLITANA DE SANTIAGO,7,DISTRITO 13,LA CISTERNA,2766,13109,81931,28899,18881,357,91,47780,48228,0.5886416618862214,0.07797548582643793
DE VALPARAISO,6,DISTRITO 6,LA CRUZ,2561,5504,16779,5571,4915,109,32,10486,10627,0.6333512128255557,0.08594594033111262
DEL LIBERTADOR GENERAL BERNARDO O'HIGGINS,8,DISTRITO 16,LA ESTRELLA,2597,6202,3799,1085,1175,14,8,2260,2282,0.6006843906291129,0.07515494210314973
METROPOLITANA DE SANTIAGO,7,DISTRITO 12,LA FLORIDA,2767,13110,308805,125000,68018,1403,445,193018,194866,0.6310325286183838,0.08037518939070515
METROPOLITANA DE SANTIAGO,7,DISTRITO 10,LA GRANJA,2768,13111,102187,38965,16501,339,117,55466,55922,0.5472516073473143,0.1194579251905011
DE COQUIMBO,5,DISTRITO 5,LA HIGUERA,2529,4104,4487,1300,654,10,4,1954,1968,0.4386004011589035,0.1552626279996922
DE VALPARAISO,6,DISTRITO 6,LA LIGUA,2553,5401,30495,10990,6698,117,39,17688,17844,0.5851451057550419,0.1323431186533528
METROPOLITANA DE SANTIAGO,7,DISTRITO 12,LA PINTANA,2769,13112,137994,49972,18549,449,172,68521,69142,0.5010507703233474,0.1531305092145046
METROPOLITANA DE SANTIAGO,7,DISTRITO 11,LA REINA,2770,13113,90939,30753,31593,844,407,62346,63597,0.6993369181539274,0.04704515049232214
DE COQUIMBO,5,DISTRITO 5,LA SERENA,2526,4101,179322,59745,39209,852,295,98954,100101,0.5582192926690535,0.1158846818550286
DE LOS RIOS,13,DISTRITO 24,LA UNION,2818,14201,35752,8200,10594,124,50,18794,18968,0.5305437458044305,0.1250073679561646
DE LOS RIOS,13,DISTRITO 24,LAGO RANCO,2820,14203,9616,1940,3085,35,31,5025,5091,0.5294301164725458,0.1359334120944532
DE AYSEN DEL GENERAL CARLOS IBAÑEZ DEL CAMPO,15,DISTRITO 27,LAGO VERDE,2738,11102,1247,255,316,7,5,571,583,0.46752205292702487,0.06079637956506091
DE MAGALLANES Y DE LA ANTARTICA CHILENA,16,DISTRITO 28,LAGUNA BLANCA,2748,12102,822,166,173,2,3,339,344,0.41849148418491483,0.04931501555663354
DEL BIOBIO,11,DISTRITO 21,LAJA,2664,8304,21631,4594,5656,97,36,10250,10383,0.4800055475937312,0.1351941484837018
METROPOLITANA DE SANTIAGO,7,DISTRITO 8,LAMPA,2794,13302,62829,20285,15090,273,268,35375,35916,0.57164685097646,0.101971894824175
DE LOS RIOS,13,DISTRITO 24,LANCO,2812,14103,16367,4090,4208,61,29,8298,8388,0.5124946538767031,0.1425972316776826
DEL LIBERTADOR GENERAL BERNARDO O'HIGGINS,8,DISTRITO 16,LAS CABRAS,2585,6107,20829,6030,4833,53,26,10863,10942,0.5253252676556723,0.1115536843479069
METROPOLITANA DE SANTIAGO,7,DISTRITO 11,LAS CONDES,2771,13114,271386,47733,132330,2934,1230,180063,184227,0.6788375229378082,0.02787233237312144
DE LA ARAUCANIA,12,DISTRITO 22,LAUTARO,2682,9108,34520,6703,11118,132,41,17821,17994,0.5212630359212052,0.1852949085178142
DEL BIOBIO,11,DISTRITO 21,LEBU,2654,8201,22302,4796,5908,94,36,10704,10834,0.48578602815890953,0.1728088251464594
DEL MAULE,9,DISTRITO 17,LICANTEN,2627,7303,6897,2219,1690,19,22,3909,3950,0.5727127736697115,0.1311718220416119
DE VALPARAISO,6,DISTRITO 6,LIMACHE,2576,5802,40056,12427,10222,202,64,22649,22915,0.5720740962652286,0.1042934712417906
DEL MAULE,9,DISTRITO 18,LINARES,2634,7401,82252,20962,23014,274,104,43976,44354,0.539245246316199,0.1094189877149527
DEL LIBERTADOR GENERAL BERNARDO O'HIGGINS,8,DISTRITO 16,LITUECHE,2598,6203,6624,2023,1924,16,9,3947,3972,0.5996376811594203,0.1220730175960753
DE VALPARAISO,6,DISTRITO 6,LLAILLAY,2571,5703,21043,8753,3601,88,28,12354,12470,0.5925961127215701,0.1251426727474609
DE LOS LAGOS,14,DISTRITO 25,LLANQUIHUE,2713,10107,16207,4639,4390,73,31,9029,9133,0.5635219349663726,0.1232217400269207
METROPOLITANA DE SANTIAGO,7,DISTRITO 11,LO BARNECHEA,2772,13115,84259,12248,46038,859,294,58286,59439,0.7054320606700768,0.05503074095958906
METROPOLITANA DE SANTIAGO,7,DISTRITO 13,LO ESPEJO,2773,13116,88815,34532,12695,295,115,47227,47637,0.5363621009964533,0.1439451335280441
METROPOLITANA DE SANTIAGO,7,DISTRITO 9,LO PRADO,2774,13117,86901,33698,15500,345,86,49198,49629,0.5710981461663271,0.1371940886012782
DEL LIBERTADOR GENERAL BERNARDO O'HIGGINS,8,DISTRITO 16,LOLOL,2605,6304,6957,1822,1989,18,11,3811,3840,0.5519620526088831,0.1438317853820431
DE LA ARAUCANIA,12,DISTRITO 23,LONCOCHE,2683,9109,23234,5063,6133,80,31,11196,11307,0.486657484720668,0.1680879841127793
DEL MAULE,9,DISTRITO 18,LONGAVI,2636,7403,27055,5066,8297,78,33,13363,13474,0.49802254666420254,0.1641776640808014
DE LA ARAUCANIA,12,DISTRITO 22,LONQUIMAY,2700,9205,12115,1878,3478,64,25,5356,5445,0.4494428394552208,0.2241622640173118
DEL BIOBIO,11,DISTRITO 21,LOS ALAMOS,2659,8206,18230,3561,5882,74,27,9443,9544,0.523532638507954,0.16938834559195531
DE VALPARAISO,6,DISTRITO 6,LOS ANDES,2549,5301,55912,19279,12976,282,96,32255,32633,0.583649306052368,0.1031862571052119
DEL BIOBIO,11,DISTRITO 21,LOS ANGELES,2661,8301,164725,28680,55225,593,231,83905,84729,0.5143663681894066,0.1345595685385791
DE LOS RIOS,13,DISTRITO 24,LOS LAGOS,2813,14104,19109,4038,5272,60,31,9310,9401,0.4919671359045476,0.145320839809035
DE LOS LAGOS,14,DISTRITO 25,LOS MUERMOS,2712,10106,16423,2499,5567,50,35,8066,8151,0.49631614199598123,0.1655464395412805
DE LA ARAUCANIA,12,DISTRITO 22,LOS SAUCES,2701,9206,7464,1156,2851,19,11,4007,4037,0.5408628081457664,0.1548463002092554
DE COQUIMBO,5,DISTRITO 5,LOS VILOS,2534,4203,18641,6614,3067,67,22,9681,9770,0.5241135132235395,0.1489742536945103
DEL BIOBIO,11,DISTRITO 21,LOTA,2647,8106,47446,13409,11045,266,89,24454,24809,0.5228891792774945,0.1445132431500428
DE LA ARAUCANIA,12,DISTRITO 22,LUMACO,2702,9207,9187,1542,3585,22,9,5127,5158,0.5614455208446718,0.2172497415837648
DEL LIBERTADOR GENERAL BERNARDO O'HIGGINS,8,DISTRITO 15,MACHALI,2586,6108,38282,13176,10630,227,62,23806,24095,0.6294080769029832,0.0697877906909054
METROPOLITANA DE SANTIAGO,7,DISTRITO 10,MACUL,2775,13118,100045,40364,22973,475,202,63337,64014,0.6398520665700435,0.06956603505032818
DE LOS RIOS,13,DISTRITO 24,MAFIL,2814,14105,7191,1527,2271,31,10,3798,3839,0.5338617716590183,0.155047140708244
METROPOLITANA DE SANTIAGO,7,DISTRITO 8,MAIPU,2776,13119,392526,167374,83812,1670,442,251186,253298,0.6453024767786083,0.07042386935675589
DEL LIBERTADOR GENERAL BERNARDO O'HIGGINS,8,DISTRITO 15,MALLOA,2587,6109,12391,3443,3370,48,22,6813,6883,0.5554838189008151,0.1187462830175634
DEL LIBERTADOR GENERAL BERNARDO O'HIGGINS,8,DISTRITO 16,MARCHIGUE,2599,6204,7159,2209,1831,28,7,4040,4075,0.5692135773152674,0.1088746204380961
DE ANTOFAGASTA,3,DISTRITO 3,MARIA ELENA,2516,2302,6173,1350,476,24,5,1826,1855,0.30050218694313946,0.17549807812142
METROPOLITANA DE SANTIAGO,7,DISTRITO 14,MARIA PINTO,2803,13504,11862,3959,2908,41,14,6867,6922,0.5835440903726185,0.1029077073562951
DE LOS RIOS,13,DISTRITO 24,MARIQUINA,2815,14106,19123,4854,4505,47,29,9359,9435,0.49338492914291693,0.1480985151512377
DEL MAULE,9,DISTRITO 17,MAULE,2616,7105,25279,6959,7158,109,43,14117,14269,0.5644606194865304,0.1265551506495703
DE LOS LAGOS,14,DISTRITO 26,MAULLIN,2714,10108,15329,2791,4086,51,29,6877,6957,0.45384565203209604,0.1313287045806746
DE ANTOFAGASTA,3,DISTRITO 3,MEJILLONES,2509,2102,10072,3050,1398,54,13,4448,4515,0.4482724384432089,0.12915202564679
DE LA ARAUCANIA,12,DISTRITO 22,MELIPEUCO,2684,9110,7723,1122,2049,19,10,3171,3200,0.41434675644179725,0.1833443838259574
METROPOLITANA DE SANTIAGO,7,DISTRITO 14,MELIPILLA,2800,13501,98064,28453,23555,305,94,52008,52407,0.5344162995594713,0.09116700637647504
DEL MAULE,9,DISTRITO 17,MOLINA,2628,7304,39735,13143,9569,164,60,22712,22936,0.5772241097269409,0.1301935928260086
DE COQUIMBO,5,DISTRITO 5,MONTE PATRIA,2538,4303,28145,7966,3924,109,55,11890,12054,0.42828211049920056,0.1605097604650675
DEL LIBERTADOR GENERAL BERNARDO O'HIGGINS,8,DISTRITO 15,MOSTAZAL,2588,6110,21204,7721,4469,97,34,12190,12321,0.5810696095076401,0.1272768475269365
DEL BIOBIO,11,DISTRITO 21,MULCHEN,2665,8305,26746,5384,7117,125,56,12501,12682,0.4741643610259478,0.1648331606416179
DEL BIOBIO,11,DISTRITO 21,NACIMIENTO,2666,8306,24563,4693,7253,101,51,11946,12098,0.4925294141595082,0.1457799117960693
DEL LIBERTADOR GENERAL BERNARDO O'HIGGINS,8,DISTRITO 16,NANCAGUA,2606,6305,15306,4839,3629,45,20,8468,8533,0.5574937932836797,0.1274791937100643
DE MAGALLANES Y DE LA ANTARTICA CHILENA,16,DISTRITO 28,NATALES,2756,12401,22672,6024,3470,68,26,9494,9588,0.42290049400141144,0.06507597762861649
DEL LIBERTADOR GENERAL BERNARDO O'HIGGINS,8,DISTRITO 16,NAVIDAD,2600,6205,7214,2376,1744,38,14,4120,4172,0.5783199334627114,0.1437315972120946
DEL BIOBIO,11,DISTRITO 21,NEGRETE,2667,8307,9084,1623,3023,37,12,4646,4695,0.5168428005284016,0.1516949069657919
DE ÑUBLE,10,DISTRITO 19,NINHUE,2838,16204,6078,1140,1991,24,7,3131,3162,0.5202369200394866,0.1402847066096666
DE VALPARAISO,6,DISTRITO 6,NOGALES,2562,5506,19714,7511,3354,78,37,10865,10980,0.5569645936897636,0.1245811936551616
DE LA ARAUCANIA,12,DISTRITO 23,NUEVA IMPERIAL,2685,9111,30850,7395,8494,166,55,15889,16110,0.5222042139384117,0.1998225542672955
DE ÑUBLE,10,DISTRITO 19,NIQUEN,2844,16303,10758,1791,3685,34,17,5476,5527,0.513757203941253,0.1918207547474952
METROPOLITANA DE SANTIAGO,7,DISTRITO 10,NUNOA,2777,13120,198985,81608,55388,1413,593,136996,139002,0.6985551674749353,0.03976587608662557
DE AYSEN DEL GENERAL CARLOS IBAÑEZ DEL CAMPO,15,DISTRITO 27,O'HIGGINS,2743,11302,758,151,168,1,1,319,321,0.4234828496042216,0.01409318297429972
DEL LIBERTADOR GENERAL BERNARDO O'HIGGINS,8,DISTRITO 15,OLIVAR,2589,6111,12567,3900,3372,66,18,7272,7356,0.5853425638577227,0.1099931903057827
DE ANTOFAGASTA,3,DISTRITO 3,OLLAGUE,2513,2202,1663,102,122,6,4,224,234,0.1407095610342754,0.1315156945162752
DE VALPARAISO,6,DISTRITO 6,OLMUE,2577,5803,16687,4771,4543,85,20,9314,9419,0.5644513693294181,0.1521418442302363
DE LOS LAGOS,14,DISTRITO 25,OSORNO,2726,10301,143216,40375,37894,620,173,78269,79062,0.5520472572896883,0.1052700931000829
DE COQUIMBO,5,DISTRITO 5,OVALLE,2536,4301,92330,27498,16242,385,135,43740,44260,0.4793674861908372,0.1112188342625878
METROPOLITANA DE SANTIAGO,7,DISTRITO 14,PADRE HURTADO,2808,13604,46684,19359,10189,203,69,29548,29820,0.638762745266044,0.09019072645541754
DE LA ARAUCANIA,12,DISTRITO 23,PADRE LAS CASAS,2686,9112,59516,13289,16904,233,93,30193,30519,0.5127864775858593,0.1886901110082478
DE COQUIMBO,5,DISTRITO 5,PAIHUANO,2530,4105,5295,1648,1077,22,7,2725,2754,0.5201133144475921,0.1209086267745504
DE LOS RIOS,13,DISTRITO 24,PAILLACO,2816,14107,19298,4229,5815,79,22,10044,10145,0.5257021453000311,0.1476450440933675
METROPOLITANA DE SANTIAGO,7,DISTRITO 14,PAINE,2799,13404,55091,17617,14711,234,73,32328,32635,0.5923835109182988,0.1104054586579299
DE LOS LAGOS,14,DISTRITO 26,PALENA,2736,10404,2322,441,449,3,5,890,898,0.3867355727820844,0.1292008134605995
DEL LIBERTADOR GENERAL BERNARDO O'HIGGINS,8,DISTRITO 16,PALMILLA,2607,6306,10565,3119,2832,33,19,5951,6003,0.5681968764789399,0.1007998370126588
DE LOS RIOS,13,DISTRITO 24,PANGUIPULLI,2817,14108,35619,7035,8907,162,69,15942,16173,0.454055419860187,0.140723494641199
DE VALPARAISO,6,DISTRITO 6,PANQUEHUE,2572,5704,6644,2398,1541,25,8,3939,3972,0.5978326309452138,0.1067564088111562
DE VALPARAISO,6,DISTRITO 6,PAPUDO,2555,5403,6309,2318,1969,33,5,4287,4325,0.6855286099223332,0.1351679406942991
DEL LIBERTADOR GENERAL BERNARDO O'HIGGINS,8,DISTRITO 16,PAREDONES,2601,6206,7049,2065,1814,16,11,3879,3906,0.5541211519364448,0.1357993648946952
DEL MAULE,9,DISTRITO 18,PARRAL,2637,7404,38210,8478,12097,155,41,20575,20771,0.5436011515310128,0.1401077678681432
METROPOLITANA DE SANTIAGO,7,DISTRITO 13,PEDRO AGUIRRE CERDA,2778,13121,91490,39838,14930,393,118,54768,55279,0.6042081101759755,0.1169763305120818
DEL MAULE,9,DISTRITO 17,PELARCO,2617,7106,8675,2000,2648,28,10,4648,4686,0.5401729106628242,0.1426987765567778
DEL MAULE,9,DISTRITO 18,PELLUHUE,2624,7203,7912,1748,3292,33,12,5040,5085,0.6426946410515673,0.1572451332052305
DE ÑUBLE,10,DISTRITO 19,PEMUCO,2830,16105,8294,1524,2756,23,14,4280,4317,0.5204967446346757,0.1646860228844268
DEL MAULE,9,DISTRITO 17,PENCAHUE,2618,7107,10371,2356,3569,36,12,5925,5973,0.5759328897888343,0.1243111438997855
DEL BIOBIO,11,DISTRITO 20,PENCO,2648,8107,42186,14637,10102,215,78,24739,25032,0.5933722087896458,0.1251148760105386
METROPOLITANA DE SANTIAGO,7,DISTRITO 14,PENAFLOR,2809,13605,73422,29349,15169,353,95,44518,44966,0.6124322410176787,0.08981981268485653
METROPOLITANA DE SANTIAGO,7,DISTRITO 11,PENALOLEN,2779,13122,190640,74617,39713,913,375,114330,115618,0.6064729332773815,0.1060549070080649
DEL LIBERTADOR GENERAL BERNARDO O'HIGGINS,8,DISTRITO 16,PERALILLO,2608,6307,10158,3284,2630,43,20,5914,5977,0.5884032289820831,0.1146140301769422
DE LA ARAUCANIA,12,DISTRITO 22,PERQUENCO,2687,9113,6814,1555,2162,35,10,3717,3762,0.5520986204872321,0.1867871689435663
DE VALPARAISO,6,DISTRITO 6,PETORCA,2556,5404,9415,3678,1370,42,12,5048,5102,0.5419012214551248,0.1155984591418075
DEL LIBERTADOR GENERAL BERNARDO O'HIGGINS,8,DISTRITO 16,PEUMO,2590,6112,12895,4842,2524,54,19,7366,7439,0.5768902675455603,0.09215923884785307
DE TARAPACA,2,DISTRITO 2,PICA,2507,1405,5663,1290,1433,12,6,2723,2741,0.48401907116369414,0.16797826806585
DEL LIBERTADOR GENERAL BERNARDO O'HIGGINS,8,DISTRITO 16,PICHIDEGUA,2591,6113,17017,4977,3626,53,23,8603,8679,0.5100193923723335,0.1156359262148933
DEL LIBERTADOR GENERAL BERNARDO O'HIGGINS,8,DISTRITO 16,PICHILEMU,2596,6201,16735,5797,4495,83,27,10292,10402,0.6215715566178668,0.1079701815433306
DE ÑUBLE,10,DISTRITO 19,PINTO,2831,16106,11523,1646,5046,56,14,6692,6762,0.5868263473053892,0.1585591401538749
METROPOLITANA DE SANTIAGO,7,DISTRITO 12,PIRQUE,2791,13202,23505,8298,6418,125,35,14716,14876,0.6328866198681131,0.09248670123533241
DE LA ARAUCANIA,12,DISTRITO 23,PITRUFQUEN,2688,9114,23226,4489,7534,87,27,12023,12137,0.5225609231034186,0.1590821382683776
DEL LIBERTADOR GENERAL BERNARDO O'HIGGINS,8,DISTRITO 16,PLACILLA,2609,6308,8296,2666,2104,29,10,4770,4809,0.5796769527483124,0.1273022635340989
DE ÑUBLE,10,DISTRITO 19,PORTEZUELO,2839,16205,5797,1204,2032,20,7,3236,3263,0.5628773503536312,0.1739075168442781
DE MAGALLANES Y DE LA ANTARTICA CHILENA,16,DISTRITO 28,PORVENIR,2753,12301,6108,1585,820,16,4,2405,2425,0.3970203012442698,0.0832902288031185
DE TARAPACA,2,DISTRITO 2,POZO ALMONTE,2503,1401,11891,2121,2460,54,15,4581,4650,0.39105205617694055,0.1564674212028224
DE MAGALLANES Y DE LA ANTARTICA CHILENA,16,DISTRITO 28,PRIMAVERA,2754,12302,1229,215,100,5,1,315,321,0.2611879576891782,0.08490175358193426
METROPOLITANA DE SANTIAGO,7,DISTRITO 10,PROVIDENCIA,2780,13123,170892,49489,53071,1434,705,102560,104699,0.6126617980947031,0.03642610433463418
DE VALPARAISO,6,DISTRITO 6,PUCHUNCAVI,2545,5105,16733,6088,4007,79,37,10095,10211,0.61023127950756,0.1330054952602058
DE LA ARAUCANIA,12,DISTRITO 23,PUCON,2689,9115,29594,6761,8101,120,42,14862,15024,0.507670473744678,0.1526781994431276
METROPOLITANA DE SANTIAGO,7,DISTRITO 8,PUDAHUEL,2781,13124,169810,67932,31217,648,214,99149,100011,0.5889582474530357,0.08886383032551015
METROPOLITANA DE SANTIAGO,7,DISTRITO 12,PUENTE ALTO,2790,13201,403129,162727,68773,1541,418,231500,233459,0.579117354494467,0.07986780328902546
DE LOS LAGOS,14,DISTRITO 26,PUERTO MONTT,2707,10101,189727,50224,51340,830,287,101564,102681,0.5412039403985727,0.1046858523400807
DE LOS LAGOS,14,DISTRITO 25,PUERTO OCTAY,2727,10302,9074,2592,2095,36,11,4687,4734,0.5217103813092352,0.1383291876203928
DE LOS LAGOS,14,DISTRITO 25,PUERTO VARAS,2715,10109,43875,11164,15117,289,110,26281,26680,0.6080911680911681,0.08434456097364984
DEL LIBERTADOR GENERAL BERNARDO O'HIGGINS,8,DISTRITO 16,PUMANQUE,2610,6309,4262,1221,1220,14,5,2441,2460,0.5771938057250118,0.130852562126145
DE COQUIMBO,5,DISTRITO 5,PUNITAQUI,2539,4304,10782,3043,1518,40,23,4561,4624,0.42886291968094975,0.1461377903985542
DE MAGALLANES Y DE LA ANTARTICA CHILENA,16,DISTRITO 28,PUNTA ARENAS,2747,12101,121724,38851,24476,598,150,63327,64075,0.5263957806184483,0.05367519475385161
DE LOS LAGOS,14,DISTRITO 26,PUQUELDON,2721,10206,4406,1159,610,9,7,1769,1785,0.40512936904221514,0.1067853483738742
DE LA ARAUCANIA,12,DISTRITO 22,PUREN,2703,9208,12240,2105,4300,25,21,6405,6451,0.5270424836601307,0.2154098820354041
DE LOS LAGOS,14,DISTRITO 25,PURRANQUE,2728,10303,19788,4509,5830,68,44,10339,10451,0.5281483727511623,0.1155043829882641
DE VALPARAISO,6,DISTRITO 6,PUTAENDO,2573,5705,14163,5049,2676,51,20,7725,7796,0.5504483513379934,0.1347218897601208
DE ARICA Y PARINACOTA,1,DISTRITO 1,PUTRE,2824,15201,5748,493,948,23,5,1441,1469,0.2555671537926235,0.2044309405630109
DE LOS LAGOS,14,DISTRITO 25,PUYEHUE,2729,10304,11691,2899,3418,47,22,6317,6386,0.5462321443845694,0.1467465551451197
DE LOS LAGOS,14,DISTRITO 26,QUEILEN,2722,10207,6234,1573,1104,16,7,2677,2700,0.4331087584215592,0.1412175718072795
DE LOS LAGOS,14,DISTRITO 26,QUELLON,2723,10208,23017,5543,4458,104,46,10001,10151,0.44102185341269495,0.1193818634298467
DE LOS LAGOS,14,DISTRITO 26,QUEMCHI,2724,10209,8963,1974,1697,20,13,3671,3704,0.4132544906839228,0.1003606374371812
DEL BIOBIO,11,DISTRITO 21,QUILACO,2668,8308,4359,1005,1337,15,12,2342,2369,0.5434732736866253,0.1970343091244608
METROPOLITANA DE SANTIAGO,7,DISTRITO 8,QUILICURA,2782,13125,141793,57492,27092,532,168,84584,85284,0.6014683376471335,0.08540059746175746
DEL BIOBIO,11,DISTRITO 21,QUILLECO,2669,8309,9620,1546,3126,28,15,4672,4715,0.4901247401247401,0.1834968633628476
DE ÑUBLE,10,DISTRITO 19,QUILLON,2832,16107,15977,3084,5248,73,20,8332,8425,0.527320523252175,0.1677132988988767
DE VALPARAISO,6,DISTRITO 6,QUILLOTA,2558,5501,75874,23622,18538,335,100,42160,42595,0.5613912539209742,0.1020958924588002
DE VALPARAISO,6,DISTRITO 6,QUILPUE,2575,5801,135645,46570,33856,685,197,80426,81308,0.599417597404991,0.09269498526731687
DE LOS LAGOS,14,DISTRITO 26,QUINCHAO,2725,10210,9251,2405,1128,28,20,3533,3581,0.38709328721219327,0.1430175616056153
DEL LIBERTADOR GENERAL BERNARDO O'HIGGINS,8,DISTRITO 15,QUINTA DE TILCOCO,2592,6114,12463,4183,3093,58,25,7276,7359,0.5904677846425419,0.1311892939438885
METROPOLITANA DE SANTIAGO,7,DISTRITO 9,QUINTA NORMAL,2783,13126,101182,36627,19317,369,119,55944,56432,0.557727659069795,0.09167410375069088
DE VALPARAISO,6,DISTRITO 6,QUINTERO,2546,5107,25195,8623,5427,108,50,14050,14208,0.5639214129787656,0.1358435300028938
DE ÑUBLE,10,DISTRITO 19,QUIRIHUE,2835,16201,10977,2665,3051,59,17,5716,5792,0.5276487200510157,0.1489056307568509
DEL LIBERTADOR GENERAL BERNARDO O'HIGGINS,8,DISTRITO 15,RANCAGUA,2579,6101,195074,65759,44445,936,246,110204,111386,0.570993571670238,0.08931715286601989
DE ÑUBLE,10,DISTRITO 19,RANQUIL,2840,16206,5833,1372,1961,26,6,3333,3365,0.5768901080061718,0.1526130334050655
DEL MAULE,9,DISTRITO 17,RAUCO,2629,7305,10014,2513,2927,42,8,5440,5490,0.54823247453565,0.1401534281927948
METROPOLITANA DE SANTIAGO,7,DISTRITO 9,RECOLETA,2784,13127,140460,49686,25705,684,207,75391,76282,0.5430869998576107,0.1323969777194035
DE LA ARAUCANIA,12,DISTRITO 22,RENAICO,2704,9209,9806,1910,3146,41,16,5056,5113,0.5214154599224964,0.1783981592525945
METROPOLITANA DE SANTIAGO,7,DISTRITO 9,RENCA,2785,13128,115788,44396,18355,400,140,62751,63291,0.5466110477769717,0.101571526291727
DEL LIBERTADOR GENERAL BERNARDO O'HIGGINS,8,DISTRITO 15,RENGO,2593,6115,49052,16478,10859,172,86,27337,27595,0.5625662562178912,0.1053760041336181
DEL LIBERTADOR GENERAL BERNARDO O'HIGGINS,8,DISTRITO 15,REQUINOA,2594,6116,23324,7165,6228,103,23,13393,13519,0.5796175613102383,0.1049125544790632
DEL MAULE,9,DISTRITO 18,RETIRO,2638,7405,17799,3072,6213,31,29,9285,9345,0.5250294960391033,0.1705386316586992
DE VALPARAISO,6,DISTRITO 6,RINCONADA,2551,5303,9605,3487,2446,34,10,5933,5977,0.6222800624674648,0.1211824985422613
DE LOS RIOS,13,DISTRITO 24,RIO BUENO,2821,14204,30798,6366,9462,117,38,15828,15983,0.5189622702772907,0.1356899812357484
DEL MAULE,9,DISTRITO 17,RIO CLARO,2619,7108,12186,2992,3551,51,27,6543,6621,0.5433284096504185,0.126841910734392
DE COQUIMBO,5,DISTRITO 5,RIO HURTADO,2540,4305,4933,1137,882,19,17,2019,2055,0.41658220150010133,0.1297430841988361
DE AYSEN DEL GENERAL CARLOS IBAÑEZ DEL CAMPO,15,DISTRITO 27,RIO IBANEZ,2746,11402,2971,714,837,15,2,1551,1568,0.5277684281386739,0.1465189166618413
DE LOS LAGOS,14,DISTRITO 25,RIO NEGRO,2730,10305,13459,3372,3803,50,24,7175,7249,0.5385987071847834,0.1332021968258645
DE MAGALLANES Y DE LA ANTARTICA CHILENA,16,DISTRITO 28,RIO VERDE,2749,12103,750,140,150,2,1,290,293,0.39066666666666666,0.1313452281192275
DEL MAULE,9,DISTRITO 17,ROMERAL,2630,7306,14037,3564,4282,56,31,7846,7933,0.5651492484149034,0.1204571307593438
DE LA ARAUCANIA,12,DISTRITO 23,SAAVEDRA,2690,9116,13239,3144,3074,71,35,6218,6324,0.4776795830500793,0.2231729952762196
DEL MAULE,9,DISTRITO 17,SAGRADA FAMILIA,2631,7307,16115,5083,4070,68,21,9153,9242,0.573502947564381,0.1128258184368657
DE COQUIMBO,5,DISTRITO 5,SALAMANCA,2535,4204,23633,7357,4080,83,36,11437,11556,0.4889772775356493,0.09605913381980427
DE VALPARAISO,6,DISTRITO 7,SAN ANTONIO,2563,5601,78647,32363,13640,323,97,46003,46423,0.5902704489681743,0.1161812418421678
METROPOLITANA DE SANTIAGO,7,DISTRITO 14,SAN BERNARDO,2796,13401,228550,77034,42372,775,225,119406,120406,0.526825639903741,0.1068160494608332
DE ÑUBLE,10,DISTRITO 19,SAN CARLOS,2842,16301,47823,9387,14747,173,63,24134,24370,0.5095874370072977,0.1449159329220292
DEL MAULE,9,DISTRITO 17,SAN CLEMENTE,2620,7109,37611,9537,9050,159,56,18587,18802,0.4999069421179974,0.1498702095318675
DE VALPARAISO,6,DISTRITO 6,SAN ESTEBAN,2552,5304,15496,5322,3731,110,26,9053,9189,0.5929917398038204,0.1075144521751857
DE ÑUBLE,10,DISTRITO 19,SAN FABIAN,2845,16304,5149,1189,1624,18,9,2813,2840,0.5515634103709458,0.186760041420435
DE VALPARAISO,6,DISTRITO 6,SAN FELIPE,2569,5701,60113,20196,13519,257,98,33715,34070,0.5667659241761349,0.1101296801287504
DEL LIBERTADOR GENERAL BERNARDO O'HIGGINS,8,DISTRITO 16,SAN FERNANDO,2602,6301,63060,20064,15795,262,72,35859,36193,0.5739454487789407,0.08944661532876297
DE MAGALLANES Y DE LA ANTARTICA CHILENA,16,DISTRITO 28,SAN GREGORIO,2750,12104,715,136,127,1,1,263,265,0.3706293706293706,0.07784760346565395
DE ÑUBLE,10,DISTRITO 19,SAN IGNACIO,2833,16108,14746,2472,5328,50,20,7800,7870,0.5337040553370406,0.1867245521650015
DEL MAULE,9,DISTRITO 18,SAN JAVIER,2639,7406,39506,9327,11102,140,40,20429,20609,0.5216675947957272,0.1292668224528784
METROPOLITANA DE SANTIAGO,7,DISTRITO 10,SAN JOAQUIN,2786,13129,80763,33849,13773,323,95,47622,48040,0.5948268390228199,0.1179219485688293
METROPOLITANA DE SANTIAGO,7,DISTRITO 12,SAN JOSE DE MAIPO,2792,13203,16006,6446,3129,82,32,9575,9689,0.6053354991878046,0.0924232587070511
DE LOS LAGOS,14,DISTRITO 25,SAN JUAN DE LA COSTA,2731,10306,8249,2419,1866,34,23,4285,4342,0.5263668323433144,0.2224948259276197
METROPOLITANA DE SANTIAGO,7,DISTRITO 13,SAN MIGUEL,2787,13130,105216,38479,23570,425,148,62049,62622,0.5951756386861314,0.0533870443989982
DE ÑUBLE,10,DISTRITO 19,SAN NICOLAS,2846,16305,11810,2597,3874,54,23,6471,6548,0.5544453852667232,0.1022172478280601
DE LOS LAGOS,14,DISTRITO 25,SAN PABLO,2732,10307,10152,2710,2837,32,17,5547,5596,0.5512214342001576,0.1227197419314114
METROPOLITANA DE SANTIAGO,7,DISTRITO 14,SAN PEDRO,2804,13505,8577,1989,2622,28,13,4611,4652,0.5423807858225487,0.1326335657555596
DE ANTOFAGASTA,3,DISTRITO 3,SAN PEDRO DE ATACAMA,2514,2203,7279,2217,1072,44,12,3289,3345,0.45954114576178046,0.1457178853538329
DEL BIOBIO,11,DISTRITO 20,SAN PEDRO DE LA PAZ,2649,8108,91391,27126,27426,528,177,54552,55257,0.6046218993117484,0.1221315304585856
DEL MAULE,9,DISTRITO 17,SAN RAFAEL,2621,7110,8670,2329,2532,34,16,4861,4911,0.5664359861591696,0.13069409516428
METROPOLITANA DE SANTIAGO,7,DISTRITO 13,SAN RAMON,2788,13131,80041,30052,13143,282,122,43195,43599,0.5447083369772991,0.1312104683134168
DEL BIOBIO,11,DISTRITO 21,SAN ROSENDO,2670,8310,4362,1205,1069,15,3,2274,2292,0.5254470426409904,0.1825529438263321
DEL LIBERTADOR GENERAL BERNARDO O'HIGGINS,8,DISTRITO 16,SAN VICENTE,2595,6117,40881,13362,9620,132,59,22982,23173,0.5668403414789266,0.0924210484026514
DEL BIOBIO,11,DISTRITO 21,SANTA BARBARA,2671,8311,13350,2266,4135,37,15,6401,6453,0.48337078651685395,0.1961688929523371
DEL LIBERTADOR GENERAL BERNARDO O'HIGGINS,8,DISTRITO 16,SANTA CRUZ,2611,6310,31615,8439,8403,85,36,16842,16963,0.536549106436818,0.07671775435085675
DEL BIOBIO,11,DISTRITO 20,SANTA JUANA,2650,8109,13026,2558,4283,50,23,6841,6914,0.5307845846768002,0.1383339667736309
DE VALPARAISO,6,DISTRITO 6,SANTA MARIA,2574,5706,12169,3833,2875,64,17,6708,6789,0.5578930068206097,0.1222888696792491
METROPOLITANA DE SANTIAGO,7,DISTRITO 10,SANTIAGO,2758,13101,339067,95375,61733,1062,507,157108,158677,0.46798125444233735,0.08427568356074022
DE VALPARAISO,6,DISTRITO 7,SANTO DOMINGO,2568,5606,11869,3484,4832,74,19,8316,8409,0.7084842867975398,0.08327342321675335
DE ANTOFAGASTA,3,DISTRITO 3,SIERRA GORDA,2510,2103,2882,430,277,5,3,707,715,0.2480916030534351,0.12800390602067999
METROPOLITANA DE SANTIAGO,7,DISTRITO 14,TALAGANTE,2805,13601,58940,21906,14792,273,104,36698,37075,0.6290295215473363,0.08864676866221173
DEL MAULE,9,DISTRITO 17,TALCA,2612,7101,181299,58423,48625,761,236,107048,108045,0.5959492330349312,0.1083064748943034
DEL BIOBIO,11,DISTRITO 20,TALCAHUANO,2651,8110,131721,37805,34984,696,193,72789,73678,0.5593489268985203,0.1147120750837973
DE ANTOFAGASTA,3,DISTRITO 3,TALTAL,2511,2104,10493,3078,1382,25,15,4460,4500,0.42885733346040217,0.1316191260624666
DE LA ARAUCANIA,12,DISTRITO 23,TEMUCO,2675,9101,238028,58784,76704,1154,337,135488,136979,0.5754743139462585,0.1479079228907132
DEL MAULE,9,DISTRITO 17,TENO,2632,7308,25073,5779,6465,90,40,12244,12374,0.4935189247397599,0.1272757483947304
DE LA ARAUCANIA,12,DISTRITO 23,TEODORO SCHMIDT,2691,9117,14052,2532,5117,59,29,7649,7737,0.5505977796754911,0.2178836248184823
DE ATACAMA,4,DISTRITO 4,TIERRA AMARILLA,2519,3103,12649,3656,1844,50,20,5500,5570,0.44035101589058423,0.1231159834959295
METROPOLITANA DE SANTIAGO,7,DISTRITO 8,TILTIL,2795,13303,14962,5062,3631,71,16,8693,8780,0.586819943857773,0.1004846430364426
DE MAGALLANES Y DE LA ANTARTICA CHILENA,16,DISTRITO 28,TIMAUKEL,2755,12303,734,48,71,0,1,119,120,0.16348773841961853,0.05199495910465069
DEL BIOBIO,11,DISTRITO 21,TIRUA,2660,8207,9123,1797,3080,32,9,4877,4918,0.5390770579853118,0.2129593771268228
DE ANTOFAGASTA,3,DISTRITO 3,TOCOPILLA,2515,2301,22196,6052,2662,90,13,8714,8817,0.3972337358082537,0.08595366390246174
DE LA ARAUCANIA,12,DISTRITO 23,TOLTEN,2692,9118,10554,1931,3412,40,22,5343,5405,0.5121281030888762,0.1962422105154954
DEL BIOBIO,11,DISTRITO 20,TOME,2652,8111,50014,14515,13279,228,74,27794,28096,0.5617627064421962,0.1381390558802315
DE MAGALLANES Y DE LA ANTARTICA CHILENA,16,DISTRITO 28,TORRES DEL PAINE,2757,12402,1634,391,309,3,1,700,704,0.43084455324357407,0.06841383390363279
DE AYSEN DEL GENERAL CARLOS IBAÑEZ DEL CAMPO,15,DISTRITO 27,TORTEL,2744,11303,570,153,83,4,1,236,241,0.42280701754385963,0.05939824893168784
DE LA ARAUCANIA,12,DISTRITO 22,TRAIGUEN,2705,9210,18595,3535,6086,77,22,9621,9720,0.5227211616025813,0.1821490209414192
DE ÑUBLE,10,DISTRITO 19,TREHUACO,2841,16207,6241,1371,2072,20,7,3443,3470,0.556000640922929,0.1892536861871537
DEL BIOBIO,11,DISTRITO 21,TUCAPEL,2672,8312,13197,2994,3580,40,19,6574,6633,0.5026142305069334,0.1435734415556869
DE LOS RIOS,13,DISTRITO 24,VALDIVIA,2810,14101,139836,48381,33497,632,258,81878,82768,0.5918933607940731,0.09795622869143517
DE ATACAMA,4,DISTRITO 4,VALLENAR,2522,3301,45689,14403,6834,176,49,21237,21462,0.46974107553240385,0.1021360096039487
DE VALPARAISO,6,DISTRITO 7,VALPARAISO,2541,5101,287931,99453,51992,1258,379,151445,153082,0.5316620996002515,0.1334439387178567
DEL MAULE,9,DISTRITO 17,VICHUQUEN,2633,7309,5335,1452,1796,27,13,3248,3288,0.6163074039362699,0.140700712285621
DE LA ARAUCANIA,12,DISTRITO 22,VICTORIA,2706,9211,32607,4899,12266,117,30,17165,17312,0.5309289416382985,0.1791963746826947
DE COQUIMBO,5,DISTRITO 5,VICUNA,2531,4106,23805,7759,3894,86,27,11653,11766,0.4942659105229994,0.139967037212977
DE LA ARAUCANIA,12,DISTRITO 22,VILCUN,2693,9119,24718,4764,8190,117,38,12954,13109,0.5303422607007039,0.1721413452330799
DEL MAULE,9,DISTRITO 18,VILLA ALEGRE,2640,7407,14020,3400,4220,42,14,7620,7676,0.5475035663338088,0.1621303595987085
DE VALPARAISO,6,DISTRITO 6,VILLA ALEMANA,2578,5804,100481,33951,25937,551,151,59888,60590,0.602999572058399,0.09250797343205479
DE LA ARAUCANIA,12,DISTRITO 23,VILLARRICA,2694,9120,56170,12289,16662,207,82,28951,29240,0.5205625778885526,0.1513866746317931
DE VALPARAISO,6,DISTRITO 7,VINA DEL MAR,2547,5109,302008,93427,77174,1497,493,170601,172591,0.5714782389870467,0.1098440460985046
METROPOLITANA DE SANTIAGO,7,DISTRITO 11,VITACURA,2789,13132,88802,10511,52327,1287,565,62838,64690,0.7284745839057679,0.03334690064776136
DEL MAULE,9,DISTRITO 18,YERBAS BUENAS,2641,7408,15095,3501,4387,57,19,7888,7964,0.5275919178535939,0.1669809109986769
DEL BIOBIO,11,DISTRITO 21,YUMBEL,2673,8313,20248,4234,6134,64,42,10368,10474,0.5172856578427499,0.1649790578815277
DE ÑUBLE,10,DISTRITO 19,YUNGAY,2834,16109,16460,4048,4129,50,31,8177,8258,0.5017010935601458,0.1135300742669885
DE VALPARAISO,6,DISTRITO 6,ZAPALLAR,2557,5405,9155,2745,3518,82,37,6263,6382,0.6971054068814855,0.08629045120311152
